R 1280 720
NO ./textures/wall_1.xpm
SO ./textures/wall_2.xpm
WE ./textures/wall_3.xpm
EA ./textures/wall_4.xpm

S ./textures/sprite_1.xpm
F 220,100,0
C 225,30,0


11111111111111111111
12222222222222222221
12222222222222222221
12222222222222222221
10000000000000000001
10000000000000000001
10000000000000000001
10000000000000000001
10000000000000000001
100000000N0000000001
11111111111111111111
