R 15000000                            10000000000
NO ./textures/wall_3.xpm
SO                      ./textures/wall_3.xpm
WE ./textures/wall_3.xpm
EA ./textures/wall_4.xpm

S ./textures/sprite_2.xpm
F 255,255,15
C 150,0,255

11111111111111111
10000000000000001
10000000000000001
1111111111111111
10000002200000001
10000000000000001
100000000000N0001
10000000000000001
10000000000000001
11111111111111111
