R 1280 720
NO ./textures/wall_1.xpm
SO ./textures/wall_2.xpm
WE ./textures/wall_3.xpm
EA ./textures/wall_4.xpm

S ./textures/sprite_1.xpm
F 255,30,15
C 150,255,150

1111111111111111111111111
1000000000000000010000001
1000001010020000010000001
1000000110000000010000001
1000000000000000000000001
1111111000000000000000001
1000000000000000200000001
1000W00000000000000000001
1111111111111111111111111
