R 1280 720
NO ./textures/wall_1.xpm
SO ./textures/wall_2.xpm
WE ./textures/wall_3.xpm
EA ./textures/wall_4.xpm

S ./textures/sprite_1.xpm
F 0,0,0
C 0,0,0

1111111111111111111111111111111111111111111111111111111111111111111111111111
1000000000000000000000000000000000000000000000000000000000000000000000000001
1000000000000000000000000000000000000000000000000000000000000000000000000001
1001100110011001100110011001100110011001100110011001100110011001100110011001
1001100110011001100110011001100110011001100110011001100110011001100110011001
1000000000000000000000000000000000000000000000000000000000000000000000000001
1000000000000000000000000000000000000000000000000000000000000000000000000001
1001100110011001100110011001100110011001100110011001100110011001100110011001
1001100110011001100110011001100110011001100110011001100110011001100110011001
1000000000000000000000000000000000000000000000000000000000000000000000000001
1000000000000000000000000000000000000000000000000000000000000000000000000001
1001100110011001100110011001100110011001100110011001100110011001100110011001
1001100110011001100110011001100110011001100110011001100110011001100110011001
1000000000000000000000000000000000000000000000000000000000000000000000000001
1000000000000000000000000000000000000000000000000000000000000000000000000001
1001100110011001100110011001100110011001100110011001100110011001100110011001
1001100110011001100110011001100110011001100110011001100110011001100110011001
1000000000000000000000000000000000000000000000000000000000000000000000000001
1000000000000000000000000000000000N00000000000000000000000000000000000000001
1001100110011001100110011001100110011001100110011001100110011001100110011001
1001100110011001100110011001100110011001100110011001100110011001100110011001
1000000000000000000000000000000000000000000000000000000000000000000000000001
1000000000000000000000000000000000000000000000000000000000000000000000000001
1001100110011001100110011001100110011001100110011001100110011001100110011001
1001100110011001100110011001100110011001100110011001100110011001100110011001
1000000000000000000000000000000000000000000000000000000000000000000000000001
1000000000000000000000000000000000000000000000000000000000000000000000000001
1001100110011001100110011001100110011001100110011001100110011001100110011001
1001100110011001100110011001100110011001100110011001100110011001100110011001
1000000000000000000000000000000000000000000000000000000000000000000000000001
1000000000000000000000000000000000000000000000000000000000000000000000000001
1001100110011001100110011001100110011001100110011001100110011001100110011001
1001100110011001100110011001100110011001100110011001100110011001100110011001
1000000000000000000000000000000000000000000000000000000000000000000000000001
1000000000000000000000000000000000000000000000000000000000000000000000000001
1111111111111111111111111111111111111111111111111111111111111111111111111111
