R 1280 720
NO ./textures/sky_1.xpm
SO ./textures/wall_2.xpm
WE ./textures/wall_3.xpm
EA ./textures/wall_4.xpm

S ./textures/sprite_2.xpm
F 255,255,15
C 150,0,255

11111111111111111
10000000000000001
10000000000000001
10000002200000001
10000000000000001
10000000000000001
1000000N000000001
10000000000000001
11111111111111111
