R 100000000000000000000000 30000000000000000000000000
NO ./textures/wall_1.xpm
SO./textures/wall_2.xpm
WE ./textures/wall_3.xpm
EA ./textures/wall_4.xpm
S ./textures/sprite_2.xpm
F 100,100,100
C 80,81,0
1111111
1000001
1000001
10N0001
1000001
1111111
